%%%%%%%%%%%
%BBBBBBBBB%
%BBBBBBBBB%
%%%%%     % 
%         % 
%      _._%
%%%%%%%%%%%
