%%%%%%%%%%%
%BBBBBBBBB%
%BBBBBBBBB%
%   %     % 
%   %     % 
%      _._%
%%%%%%%%%%%
