%%%%%%%%%%%
%   %     %
%BBB      %
%   %%%   % 
%         % 
%   _._   %
%%%%%%%%%%%
