%%%%%%%%
%BBBBBB%
%      %
% x    %
%_._   %
%%%%%%%%