%%%%%%%%%%%%%%%%%
%BBBBBBBBBBBBBBB%
%BBBBBBBBBBBBBBB%
%BBBBBBBBBBBBBBB% 
%               %
%               %
%               %
%      _._      %
%%%%%%%%%%%%%%%%%