%%%%%%%%%%%%%%
%BBBBBBBBBBBB%
%BBBBBBBBBBBB%
%            %
%            % 
%   _._      % 
%%%%%%%%%%%%%%
