%%%%%%%%%%%
%|       |%
%|       .%
%|       |%
%         %
%         %
%         %
%%%%%%%%%%%