%%%%%%%%%%%%%
%|         |%
%|         .%
%|         |%
%           %
%           %
%           %
%           %
%           %
%           %
%           %
%%%%%%%%%%%%%