%%%%%%%%%%%%%
%           %
%|          %
%|          %
%|          %
%           %
%           %
%           %
%          |%
%          .%
%          |%
%           %
%           %
%%%%%%%%%%%%%