%%%%%%%%%%%%%%
%|          |%
%|          .%
%|          |%
%            %
%            %
%            %
%%%%%%%%%%%%%%