%%%%%%%%
%.    .%
% %  %.%
% % .% %
%G   P %
%%%%%%%%
