%%%%%%%
%G 	 P%
%    .%
%   G %
%     %
%.   G%
%%%%%%%