%%%%%
%.G.%
% % %
%P  %
%%%%%
