%%%%%%%
% P %%%
%   %%%
% G %%%
%   %%%
%. o%%%
%%%%%%%