%%%%%%%
%  	 P%
%G   .%
%     %
%     %
%.    %
%%%%%%%