%%%%%%%
%P 	  %
%.   G%
%     %
%     %
%    .%
%%%%%%%