%%%%%%%
% P	  %
% %%% %
% %.  %
% %%%G%
%.    %
%%%%%%%