%%%%%%%
%  	P %
% %%% %
%  .% %
%G%%% %
%    .%
%%%%%%%