%%%%%%%%%%%
%%%G     .%
%%% %%%P%%%
%%% %%% %%%
%%% %%% %%%
%.      %%%
%%%%%%%%%%%